###############
#             #
#             #
#             #
#             #
#             #
#   BBBBBBB   #
#             #
#             #
#             #
#             #
#             #
#             #
###############