###############
#             #
#             #
#             #
#             #
#             #
#   #######   #
#             #
#             #
#             #
#             #
#             #
#             #
###############