###############
#             #
#             #
#             #
#             #
#             #
#    #####    #
#             #
#             #
#             #
#             #
#             #
#             #
###############