###############
#XXXBBBBBBBCCC#
#ACCYYYZFFFGGQ#
#ACCYYYZFFFGGQ#
#ACCYYYZFFFGGQ#
#ACCYYYZFFFGGQ#
#DEEEEUUUTTTTH#
#DIIIIJJJKKKKH#
#DIIIIJJJKKKKH#
#DIIIIJJJKKKKH#
#DIIIIJJJKKKKH#
#LLMMMMMMMMMNN#
#LLMMMMOMMMMNN#
###############