###############
#AABBBBBBBBBCC#
#AABBBBBBBBBCC#
#DDEEEFFFGGGHH#
#DDEEEFFFGGGHH#
#DDEEEFFFGGGHH#
#DDEEEFFFGGGHH#
#DDIIIJJJKKKHH#
#DDIIIJJJKKKHH#
#DDIIIJJJKKKHH#
#DDIIIJJJKKKHH#
#LLMMMMMMMMMNN#
#LLMMMMOMMMMNN#
###############