###############
#             #
#             #
#             #
#             #
#             #
#             #
#      R      #
#             #
#             #
#             #
#             #
#             #
###############