###############
#             #
#             #
#             #
#             #
#             #
#   #######   #
#             #
#    K   H    #
#   K     H   #
#  K       H  #
#             #
#      R      #
###############