###############
#             #
#             #
#             #
#             #
#             #
#   BBBBBBB   #
#             #
#    K   H    #
#   KK   HH   #
#  KK     HH  #
#             #
#      R      #
###############