##########
#        #
#        #
#        #
#        #
#        #
#        #
#        #
#   RRR  #
##########