###########
#         #
#         #
#         #
#  #####  #
#         #
#         #
#         #
#   RRR   #
###########