###############
#             #
#   H     K   #
#    H   K    #
#     H K     #
#             #
#   #######   #
#             #
#             #
#             #
#             #
#             #
#      R      #
###############