###############
#             #
#   H     K   #
#  KHH   KKH  #
# KK HH KK HH #
#             #
#   #######   #
#             #
#             #
#             #
#             #
#             #
#      R      #
###############