###############
#             #
#   H     K   #
#   HH   KK   #
#    HH KK    #
#             #
#   #######   #
#             #
#             #
#             #
#             #
#             #
#      R      #
###############