###############
######   ######
####       ####
###         ###
##  FA   FA  ##
#    ZH KY    #
#             #
#   BBBBBBB   #
#             #
#             #
##           ##
###         ###
####       ####
###### R ######
###############