###############
######   ######
####       ####
###         ###
##           ##
#             #
#             #
#   BBBBBBB   #
#             #
#             #
##           ##
###         ###
####       ####
######   ######
###############