###############
######AAA######
####AAAAAAA####
###BAAAAAAAF###
##BBCCDDDEEFF##
#BBCCCDDDEEEFF#
#BCCCDDDDDEEEF#
#GCCHHHHHHHEEI#
#GCCCJJJJJEEEI#
#GGCCCJJJEEEII#
##GGCCJJJEEII##
###GKKKKKKKI###
####KKKKKKK####
######KKK######
###############