###############
######AAA######
####AAAAAAA####
###AAAAAAAAA###
##BACCAAAEEAF##
#BBCCCDDDEEEFF#
#BCCCDDDDDEEEF#
#GCCHHHHHHHEEI#
#GCCCJJJJJEEEI#
#GGCCCJJJEEEII#
##GKCCKKKEEKI##
###KKKKKKKKK###
####KKKKKKK####
######KKK######
###############