#######################
#                     #
#                     #
#                     #
#                     #
#                     #
#     BBBBBBBBBBB     #
#                     #
#                     #
#                     #
#                     #
#                     #
#                     #
#######################