#######################
#                     #
#                     #
#                     #
#                     #
#                     #
#                     #
#          R          #
#                     #
#                     #
#                     #
#                     #
#          R          #
#######################

