#######################
#                     #
#      H       K      #
#      HH     KK      #
#       HH   KK       #
#                     #
#     BBBBBBBBBBB     #
#                     #
#                     #
#                     #
#                     #
#                     #
#          R          #
#######################